06,06,06,06,06,06,06,06,06,06,06,06,06,06,06,06,06,06,06,06,06,06,06,06,06,06,06,06,06,06,06,06,06,06,06,06,06,06,06,06,06,06,06,06,06,06,06,06,06,06
06,06,06,06,06,06,06,06,06,06,06,06,06,06,06,06,06,06,06,06,06,06,06,06,06,06,06,06,06,06,06,06,06,06,06,06,06,06,06,06,06,06,06,06,06,06,06,06,06,06
06,06,06,06,06,06,06,06,06,06,06,06,06,06,06,06,06,06,06,06,06,06,06,06,06,06,06,06,06,06,06,06,06,06,06,06,06,06,06,06,06,06,06,06,06,06,06,06,06,06
06,06,06,06,06,06,06,06,06,06,06,06,06,06,06,06,06,06,06,06,06,06,06,06,06,06,06,06,06,06,06,06,06,06,06,06,06,06,06,06,06,06,06,06,06,06,06,06,06,06
06,06,06,06,06,06,06,06,06,06,06,06,06,06,06,06,06,06,06,06,06,06,06,06,06,06,06,06,06,06,06,06,06,06,06,06,06,06,06,06,06,06,06,06,06,06,06,06,06,06
06,06,06,06,06,06,06,06,06,06,06,06,06,06,06,06,06,06,06,06,06,06,06,06,06,06,06,06,06,06,06,06,06,06,06,06,06,06,06,06,06,06,06,06,06,06,06,06,06,06
06,06,06,06,06,06,06,06,06,06,06,06,06,06,06,06,06,06,06,06,06,06,06,06,06,06,06,06,06,06,06,06,06,06,06,06,06,06,06,06,06,06,06,06,06,06,06,06,06,06
06,06,06,06,06,06,06,06,06,06,06,06,06,06,06,06,06,06,06,06,06,06,06,06,06,06,06,06,06,06,06,06,06,06,06,06,06,06,06,06,06,06,06,06,06,06,06,06,06,06
06,06,06,06,06,06,06,06,06,06,06,06,06,06,06,06,06,06,06,06,06,06,06,06,06,06,06,06,06,06,06,06,06,06,06,06,06,06,06,06,06,06,06,06,06,06,06,06,06,06
06,06,06,06,06,06,06,06,06,06,06,06,06,06,03,03,03,03,03,03,03,03,03,r1,r2,03,03,03,03,03,03,03,03,03,03,06,06,06,06,06,06,06,06,06,06,06,06,06,06,06
06,06,06,06,06,06,06,06,06,06,06,06,06,03,03,03,03,03,03,03,03,03,03,f1,f2,03,03,03,03,03,03,03,03,03,03,03,06,06,06,06,06,06,06,06,06,06,06,06,06,06
06,06,06,06,06,06,06,06,06,06,06,06,06,03,03,03,03,t1,t2,t3,03,03,03,03,03,03,03,03,03,03,03,03,03,03,03,03,06,06,06,06,06,06,06,06,06,06,06,06,06,06
06,06,06,06,06,06,06,06,06,06,06,06,06,03,03,03,03,b1,b2,b3,03,03,03,03,03,03,03,03,03,03,03,03,03,03,03,03,06,06,06,06,06,06,06,06,06,06,06,06,06,06
06,06,06,06,06,06,06,06,06,06,06,06,06,03,03,03,03,03,03,03,03,03,03,03,03,03,03,03,03,03,h1,l1,l2,h1,03,03,06,06,06,06,06,06,06,06,06,06,06,06,06,06
06,06,06,06,06,06,06,06,06,06,06,06,06,03,03,03,03,03,03,03,03,03,03,03,03,03,03,03,03,03,h1,a1,a2,h1,03,03,06,06,06,06,06,06,06,06,06,06,06,06,06,06
06,06,06,06,06,06,06,06,06,06,06,06,06,03,03,03,03,03,03,03,03,03,03,03,03,03,03,03,03,03,03,03,03,03,03,03,06,06,06,06,06,06,06,06,06,06,06,06,06,06
06,06,06,06,06,06,06,06,06,06,06,06,06,03,03,03,03,03,03,03,03,c1,c2,c2,c2,c3,03,03,03,03,03,03,03,03,03,03,06,06,06,06,06,06,06,06,06,06,06,06,06,06
06,06,06,06,06,06,06,06,06,06,06,06,06,03,03,03,03,03,03,03,03,m1,m2,m2,m2,m3,03,03,03,03,03,03,03,03,03,03,06,06,06,06,06,06,06,06,06,06,06,06,06,06
06,06,06,06,06,06,06,06,06,06,06,06,06,03,03,03,03,03,03,03,03,m1,m2,m2,m2,m3,03,03,03,03,03,03,03,03,03,03,06,06,06,06,06,06,06,06,06,06,06,06,06,06
06,06,06,06,06,06,06,06,06,06,06,06,06,03,03,03,03,03,03,03,03,m1,m2,m2,m2,m3,03,03,03,03,03,03,03,03,03,03,06,06,06,06,06,06,06,06,06,06,06,06,06,06
06,06,06,06,06,06,06,06,06,06,06,06,06,03,03,03,03,03,03,03,03,m1,m2,m2,m2,m3,03,03,03,03,03,03,03,03,03,03,06,06,06,06,06,06,06,06,06,06,06,06,06,06
06,06,06,06,06,06,06,06,06,06,06,06,06,03,03,03,03,03,03,03,03,d1,d2,d2,d2,d3,03,03,03,03,03,03,03,03,03,k1,06,06,06,06,06,06,06,06,06,06,06,06,06,06
06,06,06,06,06,06,06,06,06,06,06,06,06,03,03,03,03,03,03,03,03,03,03,03,03,03,03,03,03,03,03,03,03,03,03,k2,06,06,06,06,06,06,06,06,06,06,06,06,06,06
06,06,06,06,06,06,06,06,06,06,06,06,06,03,03,03,03,03,03,03,03,03,03,03,03,03,03,03,03,03,03,03,03,03,03,k3,06,06,06,06,06,06,06,06,06,06,06,06,06,06
06,06,06,06,06,06,06,06,06,06,06,06,06,03,03,03,03,03,03,03,03,03,03,03,03,03,03,03,03,03,03,03,03,03,03,03,06,06,06,06,06,06,06,06,06,06,06,06,06,06
06,06,06,06,06,06,06,06,06,06,06,06,06,03,03,03,03,03,03,03,03,03,03,03,03,03,03,03,03,03,03,03,03,03,03,03,06,06,06,06,06,06,06,06,06,06,06,06,06,06
06,06,06,06,06,06,06,06,06,06,06,06,06,03,03,03,03,03,03,03,03,03,03,03,03,03,03,03,03,03,03,03,03,03,03,03,06,06,06,06,06,06,06,06,06,06,06,06,06,06
06,06,06,06,06,06,06,06,06,06,06,06,06,e1,03,03,03,03,03,03,03,03,03,03,03,03,03,03,03,03,03,03,03,03,03,03,06,06,06,06,06,06,06,06,06,06,06,06,06,06
06,06,06,06,06,06,06,06,06,06,06,06,06,e2,03,03,03,03,03,03,03,03,03,03,03,03,03,03,03,03,03,03,03,03,03,03,06,06,06,06,06,06,06,06,06,06,06,06,06,06
06,06,06,06,06,06,06,06,06,06,06,06,06,06,03,03,03,03,03,03,03,03,03,03,03,03,03,03,03,03,03,03,03,03,03,03,06,06,06,06,06,06,06,06,06,06,06,06,06,06
06,06,06,06,06,06,06,06,06,06,06,06,06,06,06,06,06,06,06,06,06,06,06,03,03,03,03,06,06,06,06,06,06,06,06,06,06,06,06,06,06,06,06,06,06,06,06,06,06,06
06,06,06,06,06,06,06,06,06,06,06,06,06,06,06,06,06,06,06,06,06,06,06,03,03,03,03,06,06,06,06,06,06,06,06,06,06,06,06,06,06,06,06,06,06,06,06,06,06,06
06,06,06,06,06,06,06,06,06,06,06,06,06,06,06,06,06,06,06,06,06,06,06,06,06,06,06,06,06,06,06,06,06,06,06,06,06,06,06,06,06,06,06,06,06,06,06,06,06,06
06,06,06,06,06,06,06,06,06,06,06,06,06,06,06,06,06,06,06,06,06,06,06,06,06,06,06,06,06,06,06,06,06,06,06,06,06,06,06,06,06,06,06,06,06,06,06,06,06,06
06,06,06,06,06,06,06,06,06,06,06,06,06,06,06,06,06,06,06,06,06,06,06,06,06,06,06,06,06,06,06,06,06,06,06,06,06,06,06,06,06,06,06,06,06,06,06,06,06,06
06,06,06,06,06,06,06,06,06,06,06,06,06,06,06,06,06,06,06,06,06,06,06,06,06,06,06,06,06,06,06,06,06,06,06,06,06,06,06,06,06,06,06,06,06,06,06,06,06,06
06,06,06,06,06,06,06,06,06,06,06,06,06,06,06,06,06,06,06,06,06,06,06,06,06,06,06,06,06,06,06,06,06,06,06,06,06,06,06,06,06,06,06,06,06,06,06,06,06,06
