08,08,09,09,09,09,09,09,09,09,09,09,09,09,09,09,09,09,09,09,09,09,09,09,09,09,09,09,09,09,09,09,09,09,09,09,09,09,09,09,09,09,09,09,09,09,09,09,08,08
08,08,09,09,09,09,09,09,09,09,09,09,09,09,09,09,09,09,09,09,09,09,09,09,09,09,09,09,09,09,09,09,09,09,09,09,09,09,09,09,09,09,09,09,09,09,09,09,08,08
08,08,09,09,09,09,09,09,09,09,09,09,09,09,09,09,09,09,09,09,09,09,09,09,09,09,09,09,09,09,09,09,09,09,09,09,09,09,09,09,09,09,09,09,09,09,09,09,08,08
08,08,09,09,09,09,09,09,09,09,09,09,09,09,09,09,09,09,09,09,09,09,09,09,09,09,09,09,09,09,09,09,09,09,09,09,09,09,09,09,09,09,09,09,09,09,09,09,08,08
08,08,09,09,09,09,09,09,09,09,09,09,09,09,09,09,09,09,09,09,09,09,09,09,09,09,09,09,09,09,09,09,09,09,09,09,09,09,09,09,09,09,09,09,09,09,09,09,08,08
08,08,09,09,09,09,09,09,09,09,09,09,09,09,09,09,09,09,09,09,09,09,09,09,09,09,09,09,09,09,09,09,09,09,09,09,09,09,09,09,09,09,09,09,09,09,09,09,08,08
08,08,09,09,09,09,09,09,09,09,09,09,09,09,09,09,09,09,09,09,09,09,09,09,09,09,09,09,09,09,09,09,09,09,09,09,09,09,09,09,09,09,09,09,09,09,09,09,08,08
08,08,09,09,09,09,09,09,09,09,09,09,09,09,09,09,09,09,09,0h,09,09,09,09,09,09,09,09,09,09,09,09,09,09,09,09,09,09,09,09,09,09,09,09,09,09,09,09,08,08
08,08,09,09,09,09,09,09,09,09,09,09,09,09,09,09,09,09,09,09,09,09,09,09,09,09,09,09,09,09,09,09,09,09,09,09,09,09,09,09,09,09,09,09,09,09,09,09,08,08
08,08,09,09,09,09,09,09,09,09,09,09,09,09,09,09,09,09,09,09,09,09,09,09,09,09,09,09,09,09,09,09,09,09,09,09,09,09,09,09,09,09,09,09,09,09,09,09,08,08
08,08,09,09,09,09,09,09,09,09,09,09,09,09,09,09,09,09,09,09,09,09,09,09,09,09,09,09,09,09,09,09,09,09,09,09,09,09,09,09,09,09,09,09,09,09,09,09,08,08
08,08,09,09,09,09,09,09,09,09,09,09,09,09,09,09,09,09,09,09,09,09,09,09,09,09,09,09,09,09,09,09,09,09,09,09,09,09,09,09,09,09,09,09,09,09,09,09,08,08
08,08,09,09,09,09,09,09,09,09,09,09,09,09,09,09,09,09,09,09,09,09,09,09,09,09,09,09,09,09,09,09,09,09,09,09,09,09,09,09,09,09,09,09,09,09,09,09,08,08
08,08,09,09,09,09,09,09,09,09,09,09,09,09,09,09,09,09,09,09,09,09,09,09,09,09,09,09,09,09,09,09,09,09,09,09,09,09,09,09,09,09,09,09,09,09,09,09,08,08
08,08,09,09,09,09,09,09,09,09,09,09,09,09,09,09,09,09,09,09,09,09,09,09,09,09,09,09,09,09,09,09,09,09,09,09,09,09,09,09,09,09,09,09,09,09,09,09,08,08
08,08,09,09,09,09,09,09,09,09,09,09,09,09,09,09,09,09,09,09,09,09,09,09,09,09,09,09,08,09,08,09,08,08,08,09,08,09,09,09,08,09,08,09,08,08,08,09,08,08
08,08,09,09,09,09,09,09,09,09,09,09,09,09,09,09,09,09,09,09,09,09,09,09,09,09,09,09,08,09,08,09,08,09,08,09,08,08,09,09,08,09,08,09,08,09,09,09,08,08
08,08,09,09,09,09,09,09,09,09,09,09,09,09,09,09,09,09,09,09,09,09,09,09,09,09,09,09,09,08,09,09,08,08,08,09,08,09,08,09,08,09,08,09,08,08,08,09,08,08
08,08,09,09,09,09,09,09,09,09,09,09,09,09,09,09,09,09,09,09,09,09,09,09,09,09,09,09,09,08,09,09,08,09,08,09,08,09,09,08,08,09,08,09,09,09,08,09,08,08
08,08,09,09,09,09,09,09,09,09,09,09,09,09,09,09,09,09,09,09,09,09,09,09,09,09,09,09,09,08,09,09,08,09,08,09,08,09,09,09,08,09,08,09,08,08,08,09,08,08
08,08,09,09,09,09,09,09,09,09,09,09,09,09,09,09,09,09,09,09,09,09,09,09,09,09,09,09,09,09,09,09,09,09,09,09,09,09,09,09,09,09,09,09,09,09,09,09,08,08
08,08,09,09,09,09,09,09,09,09,09,09,09,09,09,09,09,09,09,09,09,09,09,09,09,09,09,09,08,08,08,09,08,08,08,09,08,08,08,09,08,09,08,09,08,08,08,09,08,08
08,08,09,09,09,09,09,09,09,09,09,09,09,09,09,09,09,09,09,09,09,09,09,09,09,09,09,09,08,09,09,09,08,09,08,09,08,09,08,09,08,09,08,09,08,09,08,09,08,08
08,08,09,09,09,09,09,09,09,09,09,09,09,09,09,09,09,09,09,09,09,09,09,09,09,09,09,09,08,08,08,09,08,08,08,09,08,09,08,09,08,09,08,09,08,08,08,09,08,08
08,08,09,09,09,09,09,09,09,09,09,09,09,09,09,09,09,09,09,09,09,09,09,09,09,09,09,09,08,09,08,09,08,08,09,09,08,09,08,09,08,09,08,09,08,09,09,09,08,08
08,08,09,09,09,09,09,09,09,09,09,09,09,09,09,09,09,09,09,09,09,09,09,09,09,09,09,09,08,08,08,09,08,09,08,09,08,08,08,09,08,08,08,09,08,09,09,09,08,08
08,08,09,09,09,09,09,09,09,09,09,09,09,09,09,09,09,09,09,09,09,09,09,09,09,09,09,09,09,09,09,09,09,09,09,09,09,09,09,09,09,09,09,09,09,09,09,09,08,08
08,08,09,09,09,09,09,09,09,09,09,09,09,09,09,09,09,09,09,09,09,09,09,09,09,09,09,09,09,09,09,09,09,09,09,09,09,09,09,09,09,09,09,09,09,09,09,09,08,08
08,08,09,09,09,09,09,09,09,09,09,09,09,09,09,09,09,09,09,09,09,09,09,09,09,09,09,09,09,09,09,09,09,09,09,09,09,09,09,09,09,09,09,09,09,09,09,09,08,08
08,08,09,09,09,09,09,09,09,09,09,09,09,09,09,09,09,09,09,09,09,09,09,09,09,09,09,09,09,09,09,09,09,09,09,09,09,09,09,09,09,09,09,09,09,09,09,09,08,08
08,08,09,09,09,09,09,09,09,09,09,09,09,09,09,09,09,09,09,09,09,09,09,09,09,09,09,09,09,09,09,09,09,09,09,09,09,09,09,09,09,09,09,09,09,09,09,09,08,08
08,08,09,09,09,09,09,09,09,09,09,09,09,09,09,09,09,09,09,08,03,03,03,03,03,03,03,03,03,08,09,09,09,09,09,09,09,09,09,09,09,09,09,09,09,09,09,09,08,08
08,08,09,09,09,09,09,09,09,09,09,09,09,09,09,09,09,09,09,08,03,03,03,03,03,03,03,03,03,08,09,09,09,09,09,09,09,09,09,09,09,09,09,09,09,09,09,09,08,08
08,08,09,09,09,09,09,09,09,09,09,09,09,09,09,09,09,09,09,08,03,03,03,03,03,03,03,03,03,08,09,09,09,09,09,09,09,09,09,09,09,09,09,09,09,09,09,09,08,08
08,08,09,09,09,09,09,09,09,09,09,09,09,09,09,09,09,09,09,08,03,03,03,03,03,03,03,03,03,08,09,09,09,09,09,09,09,09,09,09,09,09,09,09,09,09,09,09,08,08
08,08,09,09,09,09,09,09,09,09,09,09,09,09,09,09,09,09,09,08,03,03,03,03,03,03,03,03,03,08,09,09,09,09,09,09,09,09,09,09,09,09,09,09,09,09,09,09,08,08
08,08,08,08,08,08,08,08,08,08,08,08,08,08,08,08,08,08,08,08,03,03,03,03,03,03,03,03,03,08,08,08,08,08,08,08,08,08,08,08,08,08,08,08,08,08,08,08,08,08
